XXXXXX
XHXXXX
X XXFX
X XXFX
X XXFX
XXXXXX